— Герои —
Абаддон — Аваддон
Эншент апаришн, АА — Древнее видение
Магина, АМ — Антимаг
Акс — Тесак
Бэтрайдер — Наездник
Бистмастер, БМ — Укротитель зверей
Бладсикер — Кровоискатель
Баунти хантер, БХ — Гондар
Брислбак, ББ — Иглогрив
Брудмазер — Черная вдова
Хаос найт, ЦК — Рыцарь хаоса
Кристал мейден, ЦМ — Кристальная дева
Дарк сир — Мраковидящий
Дес профет, ДП — Вестница смерти
Дисраптор, Тралл — Громодел
Дум — Люцифер
Драгон найт, ДК — Рыцарь-дракон
Дроу — Темная лучница
Шейкер, ЕС — Землевержец
Таурен — Древний титан
Энчантрес — Чаровница
Воид, ФВ — Безликий ужас
Гирокоптер — Вертолетчик
Инвокер — Заклинатель
Висп — Ио
Кипер, КОТЛ — Хранитель света
Лайфстилер, ЛС — Вурдалак
Лон друид — Друид-отшельник
Ликантроп, Ликан — Оборотень
Потма — Мирана
Фурион — Лесной пророк
Найт сталкер, НС — Ночной охотник
Неруб — Служитель Никсы
Омник — Паладин
Обсидиан дестроер, Аутворлд деваурер, Сфинкс, ОД — Поглотитель миров
Фантом асасин, Фантомка, ПА — Мортред
Фантом лансер, ПЛ — Улан-фантом
Пудж — Мясник
Квин оф пейн, Квопа, КОП — Королева боли
Стелс асасин, СА — Рики
Сэнд кинг, СК — Король песков
Шадоу демон, СД — Демон мрака
Шадоу фиенд, СФ — Исчадие тьмы
Шадоу шаман — Раста
Сайленсер — Заглушитель
Скайрас мэйдж — Небесный маг
Спирит брейкер, СБ — Душегуб
Шторм спирит, СС — Дух бури
Темплар асасин, ТА — Храмовница
Тайдхантер — Волнолов
Шреддер, Тимберсо — Резак
Тинкер — Механик
Тини — Кроха
Треант — Древесный страж
Туск — Бивень
Андаинг, Дирдж — Нетленный
Венга, ВС — Мстящая душа
Веномансер — Веномант
Вайпер — Гадюка
Варлок — Чернокнижник
Вивер — Ткач
Виндранер, ВР — Ветрокрылая
Вич доктор, ВД — Знахарь

— Предметы —
Кура — курьер
Вард — Невидимый маячок
Сентри — Всевидящий маячок
Даст, дуст, пыль — Порошок прозрения
Смок, смоук — Дым обмана
Гем — Самоцвет ясновидения
Морбид — Маска ужаса
Блинк — Кинжал телепортации
Ванд — Волшебный жезл
Соул ринг — Кольцо душ
Персев, персеверанс — Амулет стойкости
Фазы — Сапоги-скороходы
Треды — Боевые ботинки
Транквилы — Сапоги спокойствия
Арканы — Чародейские сапоги
Мека — Меканизм
Пайп, пайпа — Трубка проницательности
Форс стаф — Силовой посох
Оркид, орчид — Зловредная орхидея
Рефрешер — Шар обновления
Хекс, шипстик — Коса Вайза
Армлет — Нарукавник Мордигиана
Башер — Костолом
Лотар — Клинок теней
Батл фури — Топор ярости
Этереал — Эфирный клинок
Радианс — Сияние
МКБ — Посох царя обезьян
Буриза, дедалус — Дедал
Батерфляй — Бабочка
Абисал — Клинок бездны
Худ — Накидка отторжения
Блейд мейл — Меченосная кольчуга
Соул бустер — Сфера вечности
БКБ — Посох Черного короля
Бладстоун — Камень крови
Ребра — Штурмовая кираса
Доминатор — Шлем повелителя
МОМ — Маска безумия
Маелстром — Мальстрем
Дифужал, дифуз — Рассеивающий клинок
Халберд — Небесная алебарда
Десолятор, дезоль — Истязатель
Мджолнир — Мьельнир
Гиперстоун — Камень скорости
Демон эдж — Клинок демона
Ривер — Топор налетчика
Иглсонг — Орлиный горн
Релик — Древний реликт
Аегис, иджис — Эгида

— Действия —
Апнуть куру — улучшить курьера
Ганк — нападение на вражеского игрока
Хекс — превратить врага в безобидную зверушку проклятием

— Объекты на карте —
Топ — верхняя линия
Мид — средняя линия
Бот — нижняя линия
Секрет шоп — Потайная лавка
Крип — 
Нейтралы — 

— Роли игроков —
Соло — герой, в одиночку стоящий на линии
Керри — герой с высоким потенциалом при затяжной игре
Хард-керри — герой с высоким потенциалом при очень затяжной игре
Сапорт — 
Офлейнер — 
Джанглер — 
Мидер — герой, в одиночку стоящий на средней линии
Дисейблер — герой со способностями, оглушающими или замедляющими врагов
Хилер — герой с возможностью лечить союзников