— Couriers —
Alphid of Lecaciida — Лекациида Альфид
Arnabus the Fairy Rabbit — Волшебный кролик Арнабус
Azuremir — Лазуремир
Baby Roshan — Рошанчик
Baekho — Баехо
Blotto and Stick — Блотто с палкой
Braze the Zonkey — Зишак Брейз
Captain Bamboo — Капитан Бамбук
Catakeet — Котоцып
Cluckles the Brave — Бравый кудахтун
Coco the Courageous — Отважный Коко
Cyril the Syrmeleon — Сирмелеон Сирил
Deathripper — Смерторез
Defense Season 2 War Dog — Боевой пес Дефенса-2
Dolfrat and Roshinante — Дольфрат и Рошинант
Drodo the Druffin — Друфин Дродо
Echowisp — Эховисп
El Gato — Эль Гато
Enduring War Dog — Стойкий боевой пес
Fearless Badger — Бесстрашный барсук
Fezzle-Feez the Magic Carpet Smeevil — Смивил Феско-фис на ковре-самолете
Garran Drywiz and Garactacus — Гарран Суходей и Гарактак
Golden Baby Roshan — Золотой рошанчик
Golden Greevil — Золотой гривил
Greevil — Гривил
Gwanji the Thunder Lizard — Громоящер Гванджи
Hollow Jack — Полый Джек
Inky the Hexapus — Шестиног Инки
Itsy — Крохотуля
Kangdae the Dokkaebi — Токкэби Кандэ
Kupu the Metamorpher — Метаморфер Купу
LGD's Golden Skipper — Золотой попрыгун Эл-джи-ди
Llama Llama — Лама Лама
Lockjaw the Boxhound — Гончий сундук Замкопаст
Maximilian the Beetlebear — Медвежук Максимилиан
Mighty Boar — Могучий хряк
MLG Scalehound — Чешуйчатая гончая Эм-эл-джи
Mok — Мок
Moroks Mechanical Mediary — Механический манипулятор Морока
Murrissey the Smeevil — Смивил Мурисей
NaVi's Weaselcrow — Ласковран Нави
Nibbles the Wartoise — Боевая черепаха Клевун
Nimble Ben — Проворный Бен
Osky the Ottragon — Отрагон Оски
Platinum Baby Roshan — Платиновый рошанчик
Porcine Princess Penelope — Принцесса поросят Пенелопа
Prismatic Drake — Призматический дракон
Ramnaught of Underwool — Баранавт из Подшерстья
Scuttling Scotty — Торопливый Скотти
Shagbark — Древолай
Skip the Delivery Frog — Посыльная лягушка Прыг
Smeevil — Смивил
Snaggletooth Jerry — Кривозуб Джерри
Snelfret the Snail — Улитка Снелфрет
Snowl — Сновушка
Speed Demon — Демон ярости
Star Ladder Grillhound — Звездная жарогончая
Stumpy - Nature's Attendant — Служитель природы Пеня
The Gama Brothers — Братья Гама
Throe — Страдание
Tickled Tegu — Щекотливая Тегу
Tinkbot — Мехабот
Tory the Sky Guardian — Хранитель небес Тори
Trapjaw the Boxhound — Гончий сундук Острозуб
Trusty Mountain Yak — Верный горный як
Waldi the Faithful — Верный Вальди
Woodchopper — Древогрыз
Wynchell the Wyrmeleon — Драколеон Винчел
Yonex's Rage — Ярость Йонекса

— Wards —
2012 Polycount Ward — Страж Поликаунта-2012
Aperture Science Wardcore — Сторожевое ядро Лаборатории
Augury's Guardian — Хранитель пророчеств
Black Pool Watcher — Хранитель Черного озера
Blueheart Spotter — Смотретель Голубого Сердца
Bottom Watcher — Хранитель глубин
Celestial Observatory — Небесная обсерватория
Double Vision — Двойное видение
Eye of Lyralei — Око Лиралей
Eye of the Ozkavosh — Глаз озкавоша
Eye of Thunderkeg — Око Громокега
Eyeball Fetish — Одноглазый оберег
Frozen Formation — Ледяная конструкция
Hellgazer — Адский дозорный
MLG Tethered Sentinel — Неподвижный страж Эм-эл-джи
Nightmare Beacon — Осветитель кошмаров
Ocula the Observer — Окула наблюдатель
Skywrath Sentinel — Небесный хранитель
Slayers Glare — Светило воительницы
Spell Surveyor — Смотритель заклинаний
Staff of Faith — Посох веры
Toxic Gaze — Ядовитый дозорный
Warding Guise — Наблюдательный облик
Watchful Sotdae — Бдительный сотте

— HUD Skins —
Bane Hud — Стиль Кошмара
Cruel Diretide — Зверская пора тьмы
Curiosity — Любознательность
Deepest Depths — Бездонная пучина
Dim Forest — Мрачный лес
Direstone — Зловещий камень
Dragon Scale — Чешуя дракона
Driftwood — Древесина
Elder Bark — Древняя кора
Empowered — Могущество
Familiar Woods — Знакомые леса
Frozen Touch — Простирание льда
Furnace — Пекло
Gear Tooth — Зубчатые колеса
Golden Treasures — Золотые сокровища
Iron Cage — Железная клетка
Jungle Ruin — Заросшие развалины
Malice — Злонравие
Mana Pool — Фонтан маны
MLG Stronghold — Крепость Эм-эл-джи
Nature — Природа
Necropolis — Некрополь
Omen — Знамение
Powered Star — Силовая звезда
Radiant Ore — Сияющая руда
Reign of Maelrawn — Царство Мелрона
Snows of Frostivus — Снега Отморожества
Stone Ruin — Каменные руины
Surge — Импульс
Tempest Wing — Крылья бури
Thunder Spirit — Дух грозы
Timber Fury — Ярость лесов
Tremor — Колебание
Underwater — Глубина
Valor — Доблесть
Vermilion — Вермильон

— Taunts —
Beautiful Snowangel — Снежный ангел
Bo Staff Beckon — Подзывание
Canonical Blast — Выстрел из пушки
Celebration of Death — Празднование смерти
Come and Get It! — Приди и получи!
Dive! Dive! — 
Double-Headed Roar — Двуглавый рык
Face the Juggernaut — 
Fish Treat — 
For Death and Honor — За смерть и честь
Get Burned — Обжигание
Good Day Sir! — Всего доброго!
Icemelter — 
Keep an Ear Out — Будь на чеку
Murder Lute — Убийственная лютня
Playful Snowball — Игривый снежок
Shake Your Money Maker — Потряси пузом
Sharp Blade — Острый клинок
Shredding the Lute Invisible — Невидимая лютня
Sniper's Celebration — Празднование Снайпера
Spider Shuffle — Танец пауков
The Magic Ends Here — Конец магии
Tooting the Horn — 
Victory Jig — Победный танец
You! — Ты!

— Gems —
Ascendant Gem — Влаственный самоцвет
Autograph Rune — Руна с автографом
Ethereal Gem — Эфирный самоцвет
Foulfell Shard — Скверный осколок
Inscribed Gem — Надписанный самоцвет
Kinetic Gem — Подвижный самоцвет
Mastery Gem — Самоцвет мастерства
Prismatic Gem — Призменный самоцвет
Rune of the Duelist Indomitable — Руна неукротимого дуэлянта
Spectator Gem — Самоцвет наблюдателя

— Ascendant Gems —
Ascendant Orb — Шар всевластия
Bloodstone of the Ancestor — Камень крови предков
Bloodstone of the Precursor — Камень крови прародителей
Bloodstone of the Founder — Камень крови родоначальников
Gem of Taegeuk — Самоцвет тхэгыка

— Essences —
Essence of Magic — Волшебная субстанция
Exort Essence — Субстанция экзорта
Quas Essence — Субстанция каса
Shadow Essence — Теневая субстанция
Unusual Essence — Необычная субстанция
Wex Essence — Субстанция векса

— Fantasy Challenge —
Seer's Bounty — Награда гадателя
Diviner's Bounty — Награда предсказателя
Augur's Bounty — Награда ясновидца
Prophet's Bounty — Награда пророка

— Wraith-Night —
Shining Fragments — Сияющие фрагменты
Phantom Fragments — Фантомные фрагменты
Wraith King's Favor — Милость Призрачного короля
Wraith King's Relic — Реликт Призрачного короля
Wraith-Night Feretory — Мощевик Ночи призраков
Wraith-Night Offering — Подношение Ночи призраков
Wraith-Night Ossuary — Погребальная урна Ночи призраков
Wraith-Night Tribute — Дар Ночи призраков

— Other Items —
Armory Expander — Расширитель арсенала
Artificer's Brand — Печать мастера
Artificer's Chisel — Долото мастера
Artificer's Hammer — Молот мастера
Breathtaking Benefaction — Поразительное благодеяние
Description Tag — Ярлык для описания
Legendary Largesse — Дар легендарной щедрости
Name Tag — Ярлык для названия
Seasonal Gift — Сезонный подарок
Shopkeeper's Surprise — Подарок лавочника

— Chests —
Treasure of the Artisan Enthralled — Сундук покоренного ремесленника
Welcoming Chest — Приветственный сундук
Locked Gemstone Cache — Закрытый тайник самоцветов
Treasure of Heroic Bounty — Сундук геройской награды
Treasure of Earth Essence — Сундук земной субстанции
Treasure of Ember Essence — Сундук пламенной субстанции
Ancient Scroll Case — Древний футляр для свитков
Emerald Polycount Collection — Изумрудная коллекция Поликаунта
Treasure of Rubiline Sheen — Сундук рубилинового блеска
Treasure of Champions 2013 — Сундук чемпионов-2013
Lockless Luckbox — Беззамочный сундук везунчика
Quirt's Summer Stash — Летний сундук Квирта
Treasure of Incandescent Wax — Сундук из раскаленного воска
Treasure of the Malignant Amanita — Сундук зловредного мухомора
Treasure of the Shaper Divine — Сундук богослова
Treasure of Rarities — Сундук редкостей
Treasure of the Cursed Wood — Сундук из проклятого дерева
Treasure of Crystalline Chaos — Сундук кристаллинового хаоса
Treasure of the Forbidden Lotus — Сундук запретного лотуса
Treasure of Dark Implements — Сундук темных обрядов
Treasure of Tidal Power — Сундук морской мощи
Treasure of the Restless Sea — Сундук Бурного моря
Treasure of the Omniscient — Сундук Всезнающего
Frosty Treasure of Frostivus — Морозный сундук Отморожества
Treasure of the Silent Grove — Сундук Тихой рощи
Treasure of the Hunted Dragon — Сундук загнанного дракона
Treasure of the Twins — Сундук Близнецов
Ghastly Treasure of Diretide — Жуткий сундук поры тьмы
Treasure of the Wild Claw — Сундук Дикого Когтя
Timeless Treasure of Claszureme — Вневременный сундук Клазурима
Treasure of the Rogue Knight — Сундук мятежного рыцаря
Treasure of Challengers — Сундук претендентов
Treasure of Champions — Сундук чемпионов
Treasure of Profound Mysteries — Сундук великих таинств
The Defense 2 Chest — Сундук Дефенса-2
Sithil's Summer Stash — Летний сундук Сизила
Treasure of the High Tide — Сундук приливов
Treasure of the Ancestor Spirits — Сундук духов предков
Treasure of the Pangolin GuildMasters — Сундук панголинских мастеров
Treasure of the Red Mist — Сундук Красного Тумана
Treasure of the Deep Druids — Сундук лесных друидов
Lost Treasure of the Ivory Isles — Потерянный сундук Белых островов